S.....#....
.#####.###.
.#.....#...
.#.###.#.#.
.#.#.....#.
.#.#######.
.#.........
.#########.
...........
##########G
